1999 Rare / Promo: Eiko, Wu Lan, Zeppo
2000 Rare / Promo: Gordo, Me am ORK!, Rikachu
2004 Origins: Amara Wintersword, Beatnik Turtle, Billy Shakespeare, Captain Bingo, Cheese Weasel, Delt Rage, Drew's Truck, Igor (promo), Mike Young, Oni, Reggie Rage, Rold Rage, Spite, Super Germ
2005 Rare Promo: Kitty Cat Seven, Magical Witch Critical Miss, Sylvia Branham
50 States: Alabama, Alaska, Arkansas, Colorado, Delaware, Georgia (US), Idaho, Illinois, Indiana, Kansas, Kentucky, Maine, Massachusetts, Michigan, Minnesota, Missouri, Nebraska, New Hampshire, New Jersey, New Mexico, New York, North Carolina, North Dakota, Ohio, Oklahoma, Rhode Island, South Carolina, Texas, Utah, Vermont, Virginia, Washington, West Virginia, Wisconsin, Wyoming
7 deadly sins: Anger, Envy, Gluttony, Greed, Lust, Pride, Sloth
BRAWL: Angora, Bennett, Chris, Darwin, Hale, Morgan, Nickie, Pearl, Sonia, Sydney, Tamiya
BROM: Bane, Coil, Crusher, Echo, Giant, Grist, Lucky, Peace, Reaver, Shepherd, Strik, Wastenott
Big Top: Firebreather, Monkeys, Ringmaster, Stumbling Clowns
Blademasters: Arashi, Danielle, Danny, Horace, Inez, Johnny, Kainar, Macky, Magistra, Michie, Renee, Scott
Blademasters: The Second Shot: Gideon, Paris, Regina
Blademasters: Third Attack: Chantal, Fuyuko, Jean-Paul, Montague (Blademasters), Montgomery, Seiji, Yamaichi
Bridge and Tunnel: Lisa, Nethershadow, Phantom Zero, Phuong, The Fog, Uncle Scratchy
Bruno: Bruno, Pappy, Synthia, The GM
Button Brains: Al-Khwarizmi, Carl Friedrich Gauss, Fan Chung Graham, Leonard Eugene Dickson, Paul Erdos, Pythagoras, Ron Graham, Theano
Buttonlords: Gawaine, Guenever, King Arthur, Lancelot, Merlin, Mordred, Morgan Le Fay
Chicago Crew: Audrey, Cheathem, Flint, Lizzie, Monty Brown, Octavia, Spooky
Classic Fanatics: ABCGi, Alljazzedup80, Anders, Anti-Llama, Anvil, Aysez, Binder, BlackOmega, Bodie, BrashTech, BugRoger, CactusJack, Caligari, Calmon, CestWhat, Conspyre, Coyote, Cristofore, Darrin, Darthcliff, Discordia, DocBlue, Downen, Durak666, Famous, Fanaka66, Finngall, Foxlady, GorgorBey, GreatWolf, GripTiger, Grivan, Grym, Heath, Heather, Hooloovoo, Hrodgar, IIconfused, Jasyeman, Jordan, Jota, Kaeriol, KaijuGamer, Kurosuke, LadyJ, Limax, Linnea, Moodster, Mushu, Nihlathak, Noeh, NoopMan, Notorious, Pain, Pjack, Polonius, Raupe, RavenBlack, Rumbles, SC (The Deuce), Sabathia, SailorMur, Shadowkeeper, Skeeve, Snuff, Squiddhartha, Stick, TYFTFB, TheFool, TheMachine, Torch, Totoro, TwistedRich, UncleMilo, Urbanmyth, Weylan, Yagharek, Zegota, Zomulgustar, Zophiel, Zotmeister, albertel, amica, barswanian, bigevildan, birdman, bobby 5150, bowler190, braincraft, chase, dexx, eon, fendrin, fernworthy, fxdirect, ghost walker, gman97216, grayhawk, grend, gslamm, hairlesswonder, hansolav, icarus, ifni, itachi, jeffboyardy, jgenzano, jrbrown78, juelki, kaufman, kestrel, kleric, lackey, llippen5, lunatic, maga, malarson, mgatten, mlvanbie, mneme, myxozoa, nelde, opedog, perlmunkee, pgolo, professorbooty, relsqui, roujin27, sanny, santiago, schwa, skapheles, slamkrypare, smallfrogge, spindisc, stoooooooo, trifecta, wembley-fraggle, wranklepig, wtrollkin, zaph
Cowboy Bebop: Ed, Ein, Faye, Jet, Spike, Vicious
Diceland: Buck, Cass, Crysis, Golo, Micro, Z-Don
Dork Victory: Bill, Carson, Gilly, Igor, Ken, Matt
Fairies: Little Sven, Sven, Yseulte
Fantasy: Aldric, Cesare, Chang, Dead Guy, Elihu, Farrell, Frasquito, Lark, Luce, Mischa, Nikolai, Theophilus
Four Horsemen: Death, Famine, Pestilence, War
Freaks: Max, Mister Peach, Simon, Werner
Free Radicals: CynCyn, Loren, Lorrie, Maskin, Randy, Tony
Geekz: Cammy Neko, Sailor Man, Xylene
Hodge Podge: BabyBM, Bull, Craptacualr, Crosswords, Da Pimp, Darth Maul, Eeyore, Evil Robot Luke, Horde O Ninjas, Jose, Loki, Marilyn Monroe, Miser, Qui-Gon Jinn, Skomp, The Tick, Thor, Trogdor, Tyler Durden
Iron Chef: Chairman Kaga, Iron Chef Chinese, Iron Chef French, Iron Chef Italian, Iron Chef Japanese
Japanese Beetle (unofficial): Joe McCarthy, Kremlina, Max Factor, The Flying Squirrel (unofficial), The Frenchman
Las Vegas: Frankie, Lady Luck, Magician, Sly, Them Bones, Twenty-One
Legend of the Five Rings: Crab, Crane, Dragon, Kakita, Lion, Mantis, Mirumoto, Naga, Phoenix, Ronin, Scorpion
Lunch Money: Charity, Chastity, Hope, Patience, Prudence, Temperance
Majesty: Flaire, Nerni
MegaTokyo: Darkly Cute, Erika, Ping, Piro
Metamorphers: Daisy, Jingjing, Mau, Spencer, Talus
Miscellaneous: Abe Caine, Adam Spam, Assailer, Bar Mitzvah Boy, ConMan, EDG, Ginzu, Gratch, Gripen, Howling Wolf, Judah Maccabee, Lab Rat, MAX (promo), Poly, Randarch, Social Class, The Effster, The Fictitious Alan Clark, The Flying Squirrel, Tirade, White Tiger
Presidential: Bush, Cthulhu, Gore
RandomBM: RandomBMAnime, RandomBMDuoskill, RandomBMFixed, RandomBMMixed, RandomBMMonoskill, RandomBMPentaskill, RandomBMTetraskill, RandomBMTriskill
Renaissance: MothMan
Sailor Moon 1: Jedite, Malachite, Nephlite, Queen Beryl, Sailor Jupiter, Sailor Mars, Sailor Mercury, Sailor Moon, Sailor Venus, Shadow Warriors, Tuxedo Mask, Zoycite
Sailor Moon 2: Emerald, King Endymion, Luna & Artemis, Neo-Queen Serenity, Prince Diamond, Princess Serena, Queen Serenity, Rini, Rubeus, Sapphire, Wicked Lady, Wiseman
Samurai: Honzo, Okaru, Tonase, Tsusuko, Yuranosuke
Sanctum: Dracha, Fingle, Ngozi, Ogi
Sluggy Freelance: Aylee, Bun-Bun, Kiki, Riff, Torg, Zoe
Soldiers: Avis, Changeling, Clare, Iago, Karl, Kith, Kublai, Niles, Shore, Stark
Steven Universe: Garnet, Greg Universe, Jasper, Lapis Lazuli, Lion (SU), Pearl (SU), Peridot, Rose Quartz, Steven Universe
Studio Foglio: Agatha, Bang, Brigid, Buck Godot, Dixie, Gil, Growf, Jorgi, Klaus, Krosp, O-Lass, Phil, The James Beast, Von Pinn
Tenchi Muyo!: Ayeka, Dr. Clay, Kagato, Kiyone, Mihoshi, Ryo-Ohki, Ryoko, Sasami, Soja's Guardians, Tenchi, Washu, Zero
The Core: Delia, Ferrer, Janet, Lady B, Polly, Porter, Smith, Stefano, Steve (The Core), Tanya, Tony (The Core)
The Delta: Benvenito, Brand, Doctor Fret, Felicia, Fiorina, Keegan, Min-Szu, Pilot Joe, Szechuan, Windsor
Unexploded Cow: Buckley, Elsie, George, Kasper, Montague, Neville, Thaddeus, Violette
Uptown: Amelia, Basil, Bobby, Clyde, Giuseppe, Heather (Uptown), Henry, Jesse, Ken (Uptown), Mississippi (Uptown), Montserrat, Petey, Ricky, Stubbs, Tasha
Vampyres: Buddy, McGinty, Starchylde, Tiffany
Victorian Horror: Count Dracula, Dr. Jekyll, Invisible Man, Wolfman
West Side: Beatrice, Bijay, Carson (West Side), Dietrich, Hazel, Jackie, Marin, Marta, Mickael, Mondo, Prentice, Sally, Stacie
Wonderland: Alice, Mad Hatter, The Jabberwock, Tweedledum+dee, White Rabbit
Yoyodyne: FuzzFace, John Kovalic, Pikathulhu, Ulthar
ZOECon: Carrow, Glorion, Nara, Perf, The Assassin, Wren
Zodiac: Aquarius, Aries, Capricorn, Gemini, Leo, Libra, Pisces, Sagittarius, Scorpio, Taurus


CLOSE: 1999 Rare / Promo, 2000 Rare / Promo, 2005 Rare Promo, Blademasters: The Second Shot, Fairies, Geekz, Majesty, Presidential, Renaissance
